NO textures/basic/max_verstappen.xpm                                                
SO textures/basic/max_verstappen.xpm
WE textures/basic/max_verstappen.xpm
EA textures/basic/max_verstappen.xpm

F 220,100,0
C 225,30,0

        1111111111111111111111111       111111111111
        1000000000110000000000001       110001100011
        1011000001110000000000001       111000000011
        1001000000000000000000001       110001110001
111111111011000001110000000000001       110000000001
100000000011000001110111111111111       111111111111
11110111111111011100000010001
11110111111111011101010010001
11000000110101011100000010001
11111111111111111111111111111

11111111111111111111111111111
10000000000000001100000010001
10000000000000001101010010001
1100000111010101111101111000111
11110111 1110101 101111010001
11111111 1111111 111111111111

1111111111111111111111111111111111111111111111
1000000000000000000000000000000000000000000001
1000000000000000000000000000000000000000000001
1000000000000000000000000000000000000000000001
1000000000001111111111111111111110000000000001
1000000000001                   10000000000001
1000000000001  111111111111111  10000000000001
1000000000001  100000000000001  10000000000001
1000000000001  100001111100001  10000000000001
1000000000001  100000001100001  10000000000001
1000000000001  10000000000N001  10000000000001
1000000000001  100110000000001  10000000000001
1000000000001  111111111111111  10000000000001
1000000000001                   10000000000001
1000000000001111111111111111111110000000000001
1000000000000000000000000000000000000000000001
1000000000000000000000000000000000000000000001
1000000000000000000000000000000000000000000001
1000000000000000000000000000000000000000000001
1111111111111111111111111111111111111111111111